/Dr. A.K.M. Ashikur Rahman	;ashikur @ cse . buet . ac . bd:
/Dr. Muhammad Masroor Ali	;mmasroorali@cse . buet . ac. bd:
/Dr. Md. Saidur Rahman	;saidurrahman @ cse.buet . ac. bd:
/Dr. Md. Monirul Islam	;mdmonirulislam@cse. buet. ac. bd:
/Dr. Md. Mostofa Akbar	;mostofa @ cse . buet.ac. bd:
/Dr. M. Sohel Rahman	;msrahman @ cse .buet. ac. bd:
/Dr. A.K.M. Ashikur Rahman;	ashikur @cse. buet .ac.bd:
/Dr. Mahmuda Naznin;	mahmudanaznin@gmail.com:
/Dr. Tanzima Hashem;	tanzimahashem@gmail.com:
/Dr. Md. Shohrab Hossain;	mshohrabhossain @cse. buet.ac. bd:
/Dr. Anindya Iqbal;	anindya_iqbal @yahoo . com:
/Dr. Rifat Shahriyar	;rifat@cse.buet.ac.bd:
/DR. saifur rahman	;rahman@cse.buet.ac.bd:
/Dr.Shamsuzzoha Bayzid	;shams.bayzid@gmail.com:
/Shashata Sawmya;	shashata@teacher.cse.buet.ac.bd:
/Rayhan Rashed	;rayhan@ cse.buet.ac.bd:
/Md. Toufikuzzaman	;md.toufikzaman@gmail.com:
/Tahmid Hasan	;tahmid@teacher.cse.buet.ac.bd:
/Syed Md. Mukit Rashid	;mukitrashid270596@ gmail . com:
/Md. Tareq Mahmood	;tareq. mhmd71@ gmail .com: